Nr.,A,B,C,D,E,G,J,Sum,Qualified
31,0,0,1,0,0,0,0,1,False
33,5,5,5,5,5,5,5,35,True
72,0,0,0,0,0,0,0,0,False
75,0,0,0,0,0,4,0,4,False
76,5,0,5,0,5,4,0,19,True
77,1,4,0,0,4,0,0,9,False
92,5,5,5,5,1,5,5,31,True
98,5,5,4,5,2,3,5,29,True
103,0,1,0,0,4,0,0,5,False
104,5,5,5,5,4,3,5,32,True
117,4,5,5,5,5,5,5,34,True
121,0,0,0,5,0,1,5,11,False
